{
  "name" : "TestMap",
  "tileWidth" : 10,
  "tileHeight" : 10,

  "tileList" : [
    [2, 2, 2, 1, 1, 1, 1, 1, 1, 1],
    [4, 3, 3, 3, 1, 1, 1, 1, 2, 1],
    [2, 2, 2, 3, 1, 1, 1, 1, 1, 1],
    [1, 1, 1, 3, 1, 1, 1, 3, 3, 5],
    [1, 1, 1, 3, 1, 1, 1, 3, 1, 1],
    [1, 1, 2, 3, 1, 1, 1, 3, 2, 1],
    [1, 1, 1, 3, 3, 3, 3, 3, 1, 1],
    [1, 1, 1, 1, 1, 1, 1, 1, 1, 1],
    [1, 1, 1, 1, 1, 1, 1, 1, 2, 1],
    [1, 1, 2, 1, 1, 1, 1, 1, 1, 2]
  ],

  "baseLocation": [10, 5],
  "monsterSpawnLocation": [1, 2],

  "monsterPathLength" : 17,
  "monsterDirections": [
    [4, 2, false],
    [4, 7, false],
    [8, 7, false],
    [8, 4, false],
    [10, 4, true]
  ]
}