{
  "name" : "TestMap",
  "tileWidth" : 10,
  "tileHeight" : 10,

  "tileList" : [
    [1, 1, 1, 1, 1, 2, 1, 1, 1, 1],
    [4, 3, 3, 3, 1, 1, 1, 1, 2, 1],
    [1, 2, 1, 3, 1, 2, 1, 1, 1, 1],
    [1, 1, 1, 3, 1, 1, 1, 3, 3, 5],
    [1, 1, 1, 3, 1, 1, 1, 3, 1, 1],
    [1, 1, 2, 3, 1, 1, 1, 3, 2, 1],
    [1, 1, 1, 3, 3, 3, 3, 3, 1, 1],
    [1, 1, 1, 1, 1, 1, 1, 1, 1, 1],
    [1, 1, 1, 1, 1, 1, 1, 1, 2, 1],
    [1, 1, 2, 1, 1, 1, 1, 1, 1, 1]
  ],

  "monsterPathLength" : 17,
  "monsterDirections" : [2, 2, 2, 3, 3, 3, 3, 3, 2, 2, 2, 2, 1, 1, 1, 2, 2]
}